10 10
##########
#OOOOOOOO#
#OOOOOOOO#
#OOOOOOOO#
#OOOOOOOO#
#OOO*OOOO#
#OOOOOOOO#
#OOOOOO+O#
#OOOOOOOO#
##########