10 20
####################
#OOOOOOOO##OOOOOOOO#
#OOOOOOOO##OOOOOOOO#
#OOOOOOOO##OOOOOOOO#
#OOOOOOOO##OOOOOOOO#
#OOO*OOOO##OOOOOOOO#
#OOOOOOOO##OOOOOOOO#
#OOOOOOOOOOOOO+OOOO#
#OOOOOOOOO#OOOOOOOO#
####################