20 20
####################
#OOOOOOOO##OOOOOOOO#
#OOOOOOOO##OOOOOOOO#
#OOOOOOOO##OOOOOOOO#
#OOOOOOOO##OOOOOOOO#
#OOO*OOOO##OOOOOOOO#
#OOOOOOOO##OOOOOOOO#
#OOOOOOOOOOOOOOOOOO#
#OOOOOOOOO#OOOOOOOO#
#########OO#########
#########OO#########
#OOOOOOOOO#OOOOOOOO#
#OOOOOOOO##OOOOOOOO#
#OOOOOOOO##OOOOOOOO#
#OOOOOOOO##OOOOOOOO#
#OOOOOOOO##OOOOOOOO#
#OOOOOOOO##OOOOOOOO#
#OOOOOOOOOOOOOOOOOO#
#OOOOOOOOO#OOOOOOO+#
####################